##############################
#............................#
#............................#
#............................#
#............................#
#............................#
#............................#
#............................#
#............................#
#....###########.............#
#....#.........#.............#
#....#.........#.............#
#....#.........#.............#
#....#.........#.............#
#....#.........##########....#
#....#..................#....#
#....#########.##########....#
#............#.#.............#
#............#.#.............#
#............#.#.............#
#............###.............#
#............................#
#............................#
#............................#
#............................#
##############################
