##############################
#............................#
#............................#
#............................#
#............................#
#............................#
#............................#
#............................#
#............................#
#............................#
#............................#
#............................#
#.......................#.#..#
#.......................#.#..#
#.......................#.#..#
#..............##########.#..#
#..............#..........#..#
#..............#.##########..#
#..............#.#...........#
#..............#.#...........#
#............................#
#............................#
#.##.#..................#.##.#
#..#.#..................#.#..#
##..........................##
##############################
